1111111111111111111111111111111111
1E0000000000000C00000C000001000001
10100101001000001010010000E1010101
1010010010101010001001000001010101
1P0000000C00C0000010000000000000C1
1111111111111111111111111111111111